.....................
.....................
.......@@@@@@@@@@@@@.
.......@...........@.
.......@.....@.....@.
.......@.....@.....@.
.......@.....@.....@.
.......@@@@@@@.....@.
...................@.
...................@.
..3..................
.....................
.....................
.....................
.....................
................#....
.....................
.....................
.....................
...............#.....
...................#.
.................#...
..............#...##.
....................#
...........#...#.....
.....................
.............#....#..
.....................
....................#
.....................
.....................
.....................
.......1.............
.....................
.....................
.....................
.....................
