.....................
.....................
.......@@@@@@@@@@@@@.
.......@...........@.
.......@.....@.....@.
.......@.....@.....@.
.......@.....@.....@.
.......@@@@@@@.....@.
...................@.
...................@.
.......___...........
......._~_...........
......._._...........
......._._...........
.....___.___.........
....._~_._~___..#....
....._._._._~_.......
....._._._._._.......
.~~~._....._._.......
.~____....._~_.#.....
.._~~~......__.....#.
.._~........_~...#...
..__........_.#...##.
..~_........_.......#
...___.....__..#.....
....~__...._~........
....~~_...._~#....#..
....~._...._~........
..........._........#
.....................
.....................
.....................
.....................
.....................
.....................
.....................
.....................
